recvRadarBytes	KEYWORD2
reset_func	KEYWORD2
checkSetMode_func	KEYWORD2
HumanStatic_func	KEYWORD2
showData	KEYWORD2
HumanStaticLite	KEYWORD2
radarStatus	KEYWORD2
bodysign_val	KEYWORD2
static_val	KEYWORD2
dynamic_val	KEYWORD2
dis_static	KEYWORD2
dis_move	KEYWORD2
speed	KEYWORD2
SOMEONE	KEYWORD1
NOONE	KEYWORD1
NOTHING	KEYWORD1
SOMEONE_STOP	KEYWORD1
SOMEONE_MOVE	KEYWORD1
HUMANPARA	KEYWORD1
SOMEONE_CLOSE	KEYWORD1
SOMEONE_AWAY	KEYWORD1
DETAILMESSAGE	KEYWORD1